#########################
#***********************#
#***********************#
#**********###**********#
#********#**************#
#***##****#********##***#
#****#*************#****#
#*2**#*****#*******#**1*#
#****#*************#****#
#***##*******#*****##***#
#*************#*********#
#*********###***********#
#***********************#
#########################






