###############################
#*****************************#
#*****************************#
#*****************************#
#*******#****#****************#
#********#********************#
#*****************************#
#*****************************#
#*****************************#
#*****************************#
#*****************************#
#*****************************#
#*****************************#
#*****************************#
#*****************************#
#*****************************#
#*****************************#
###############################

