#########################
#***********************#
#***********************#
#************#**********#
#**********T##**********#
#***##*************##***#
#****#*************#****#
#*2**#*************#**1*#
#****#*************#****#
#***##*****##T*****##***#
#**********#************#
#***********************#
#***********************#
#########################






